20
21
11111111111111111111
10000000030000000001
10090022030000000001
10000000030000000001
10003044440011111111
10103000030000000001
10103040030000000001
10003040030000000001
12222220030011111111
10000000000000000001
10000000000000000001
10000000000000000001
10000000040000000001
10000000040000000001
10022000040000000001
10000000040000000001
10000000040000000001
10000000040000000001
10000000040000000001
11111001111111111111
00000440000000000000
