20
20
11111111111111111111
10000000030000000001
10000000030000000001
10000000030000000001
10000000040011111111
10000000030000000001
10000000030000000001
10000000030000000001
10000000030011111111
10000000000000000001
10000000000000000001
10000000000000000001
10000000040000000001
10000000040000000001
10022000040000000001
10000000040000000001
10000000040000000001
10000000040000000001
10000000040000000001
11111111111111111111